.........a
......ca..
..dc...c..
..daf.....
..cb......
..........
..........